R 1000 1000
NO textures/wall_1.xpm
SO textures/wall_2.xpm
WE textures/wall_3.xpm
EA textures/wall_4.xpm

S textures/sprite_1.xpm

F 0,140,0
C 0,0,140

 11111 1111011111
11S0000000000001
1000000002000001
1000000000000001
1111111111111111


