R 1000 1000
NO textures/wall_1.xpm
SO textures/wall_2.xpm
WE textures/wall_3.xpm
EA textures/wall_4.xpm

X textures/star.xpm
Y textures/sprite_1.xpm

S textures/sprite_2.xpm
S textures/pillar.xpm
F 0,140,0
C 0,0,140

11111111111
10000000001
10000000001
10000X00001
10000000001
10000000001
10000000001
10000000001
10000000001
10000000001
11113031111
   10001
   13031
   10001
   13031
   10001
 111303111
 100000001
 100000001
 1000N0001
 111111111

11111111111111111111111
10000000000000000000001
10000000000000000000001
10000000110001100000001
10000000130003100000001
10000000100000100000001
10000000100000100000001
1000Y000130003100000001
10000000100000100000001
10000000100N00100000001
10000000130003100000001
10000000111111100000001
10000000000000000000001
10000000000X00000000001
11111111111111111111111

111111111111      1111111111
100010010001      1000000001
10001001000111111110000Y0001
1011100100000000000000000001
1000000000000000000001111111
111000000000000100100001
  1000020000000001001001
  1000000000011100100001
111000000000000000000111
1000000000000000000001
1000000000000000000001
1000X000000000W0000001
1000000000000000000001
1000000000000000000001
1111111111111111111111

111111111111      1111111111
100010010001      1000000001
1000100100011111111000X00001
1011100100000000000000000001
100Y000000000000000001111111
111000000000000100100001
  1000000000000001001001
  1000000000011100100001
111000000000000000000111
1000000000000000000001
1000000000000000000001
1000W00000000000000001
1000000000000000000001
1000000000000000000001
1111111111111111111111


