R 800 800
NO textures/wall_1.xpm
SO textures/wall_2.xpm
WE textures/wall_3.xpm
EA textures/wall_4.xpm

S textures/sprite_1.xpm
F 0,140,0
C 0,0,140

1111111111111111111111
1000100100000000000001
1000100100000000000001
1011100100000000000001
1000000000000000000001
1000000000000001001001
1000000000000001001001
1000000000000111001001
10000000000000W0000001
1111111111111111111111
