R 800 800
NO textures/wall_1.xpm
SO textures/wall_2.xpm
WE textures/wall_3.xpm
EA textures/wall_4.xpm

S textures/sprite_1.xpm
F 0,140,0
C 0,0,140

111111111111      1111111111
100010010001      1000000001
1000100100011111111000000001
1011100100000000000000000001
100W000000000000000001111111
111000000000000100100001
  1000000000000001001001
  1000000000011100100001
11100000000000W000000111
10000000000000W0000001
10000000000000W0000001
1111111111111111111111
